%%%%%%%%%%%%%
%           %
% %%%%    %%%
% %%%%      %
% %%%%  %%%%%
%           %
%%%%%%%%%%%%%
% % % % %%%%%
%%%%%%%%%%%%%